11
1111111111111111111
1000000000000000001
1000000010000000001
1000000010000000001
1000000010000000001
1000000000000000001
1011100000000000001
1000000000000000001
1000000000000000001
1000000000000000001
1111111111111111111
end
8
11
