37
111111111111111111111111111111111111111111111111111111111111111111111
100003100000000000000000000000000000000001000000000000000000000000001
100000100000111100000000000000000000000001000000000000000000000000001
100000100000000000000000000000000000000001000000000000000000000000001
100000100000000000000000000000000000000001000000000000000000000000001
100000100000000000000110000000000000000001000000000000000000000000001
100000100000000000000110000000000000000001000000000000000000000000001
100000100000000000000000000000000000000001000000000000000000000000001
100000100000000000000000000000000000000001000000000000000000000000001
100000111111111000000111100000000000000001000000000000000000000000001
100000000000000000000100100000000000000001000000000000000000000000001
100000000000000000000100100000000000000001000000000000000000000000001
111111111111111000000111100000000000000001000000000000000000000000001
100000000000001000000000000000000000000001000000000000000000000000001
100000000000001000000000000000000000000001000000000000000000000000001
100100000100001000000000000000000000000001000000000000000000000000001
100000000000001000000111111111111111111111100000000000000000000000001
100000000000001000000000000000000000000000000000000000000000000000001
100000100000001000000000000000000000000000000000000000000000000000001
100000000000001000000100000000011000000000000000000000000000000000001
100000000000001000000100000000011000000000000000000000000000000000001
100000000100001000000100000000000000000001100000000000000000000000001
100000000000000000000130000000000000000001100000000000000000000000001
100000000000000000000100000000011000000000000000000000000000000000001
111111111111111000000100000000011000000000000000000000000000000000001
100000000000000000000100000000000000000000000000000000000000000000001
100000000000000000000100000000000000000000011000000000000000000000001
100000000000000000000100000000000000000000011000000000000000000000001
100000000000000000000000000000000000000000011000000000000000000000001
100000000000000000000000000000000000000000011000000000000000000000001
111111111111111111111111111111111111100100000000000000000000000000001
100000000000000000000000000000000000000100000000000000000000000000001
100000000000000000000000000000000000000100000000000000000000000000001
100000001111111111111111111111111111111100000000000000000000000000001
100000000000000000000000000000000000000000000000000000000000000000001
100000000000000000000000000000000000000000000000000000000000000000001
111111111111111111111111111111111111111111111111111111111111111111111
end
3
3
tp
1
5
22
22
tp
22
22
1
5
end
4
11 3 8 3 3
9 3 8 3 3
8 4 8 3 3
22 25 12 0 0
end
